{
    "1": 100,
    "2": 200,
    "3": 300,
    "4": 500,
    "5": 800,
    "6": 1200,
    "7": 1800
}